日期序号,微博条数,积极条数,消极条数,积极转发,积极评论,积极赞,消极转发,消极评论,消极赞,总转发,总评论,总赞,平均积极转发,平均积极评论,平均积极赞,平均消极转发,平均消极评论,平均消极赞
2018/12/1,20,14,6,725,1359,3161,492,2795,3975,1217 ,4154 ,7136 ,52 ,97 ,226 ,82 ,466 ,663 
2018/12/2,21,16,5,2944,3444,18995,159,349,1559,3103 ,3793 ,20554 ,184 ,215 ,1187 ,32 ,70 ,312 
2018/12/3,30,26,4,4501,5842,15043,365,2290,2647,4866 ,8132 ,17690 ,173 ,225 ,579 ,91 ,573 ,662 
2018/12/4,30,25,5,35263,21560,46669,3215,2362,6908,38478 ,23922 ,53577 ,1411 ,862 ,1867 ,643 ,472 ,1382 
2018/12/5,30,27,3,60167,42100,30227,65,364,860,60232 ,42464 ,31087 ,2228 ,1559 ,1120 ,22 ,121 ,287 
2018/12/6,30,9,21,31467,40617,125043,171582,157437,501270,203049 ,198054 ,626313 ,3496 ,4513 ,13894 ,8171 ,7497 ,23870 
2018/12/7,30,14,16,127285,13999,59234,61792,49321,214057,189077 ,63320 ,273291 ,9092 ,1000 ,4231 ,3862 ,3083 ,13379 
2018/12/8,30,8,22,25821,22765,38447,24425,18556,64994,50246 ,41321 ,103441 ,3228 ,2846 ,4806 ,1110 ,843 ,2954 
2018/12/9,30,5,25,4007,5574,12626,22094,25847,50918,26101 ,31421 ,63544 ,801 ,1115 ,2525 ,884 ,1034 ,2037 
2018/12/10,30,14,16,14855,26782,68577,18481,33282,48032,33336 ,60064 ,116609 ,1061 ,1913 ,4898 ,1155 ,2080 ,3002 
2018/12/11,30,21,9,39173,38767,126497,4639,9474,12691,43812 ,48241 ,139188 ,1865 ,1846 ,6024 ,515 ,1053 ,1410 
2018/12/12,30,16,14,116922,102440,762254,74839,68622,313283,191761 ,171062 ,1075537 ,7308 ,6403 ,47641 ,5346 ,4902 ,22377 
2018/12/13,30,21,9,200549,38291,262557,4253,2256,15198,204802 ,40547 ,277755 ,9550 ,1823 ,12503 ,473 ,251 ,1689 
2018/12/14,30,16,14,53799,13316,22786,6309,17417,80251,60108 ,30733 ,103037 ,3362 ,832 ,1424 ,451 ,1244 ,5732 
2018/12/15,30,13,17,46982,14034,62678,1819,3858,5176,48801 ,17892 ,67854 ,3614 ,1080 ,4821 ,107 ,227 ,304 
2018/12/16,30,26,4,106770,9832,41149,2065,4772,5622,108835 ,14604 ,46771 ,4107 ,378 ,1583 ,516 ,1193 ,1406 
2018/12/17,30,24,6,314010,58968,1172647,2637,14841,16187,316647 ,73809 ,1188834 ,13084 ,2457 ,48860 ,440 ,2474 ,2698 
2018/12/18,30,23,7,50533,16027,109334,5741,9049,32161,56274 ,25076 ,141495 ,2197 ,697 ,4754 ,820 ,1293 ,4594 
2018/12/19,30,18,12,62704,34398,178667,5782,7912,20521,68486 ,42310 ,199188 ,3484 ,1911 ,9926 ,482 ,659 ,1710 
2018/12/20,30,22,8,16471,6987,21134,591,1756,2466,17062 ,8743 ,23600 ,749 ,318 ,961 ,74 ,220 ,308 
2018/12/21,30,24,6,7773,13366,21628,560,1595,1683,8333 ,14961 ,23311 ,324 ,557 ,901 ,93 ,266 ,281 
2018/12/22,28,18,10,5457,3614,6255,374,885,1676,5831 ,4499 ,7931 ,303 ,201 ,348 ,37 ,89 ,168 
2018/12/23,30,15,15,2000,2917,8632,2525,4048,4886,4525 ,6965 ,13518 ,133 ,194 ,575 ,168 ,270 ,326 
2018/12/24,30,15,15,129331,43094,128524,10236,35955,29106,139567 ,79049 ,157630 ,8622 ,2873 ,8568 ,682 ,2397 ,1940 
2018/12/25,30,24,6,47608,34397,44221,737,1111,2213,48345 ,35508 ,46434 ,1984 ,1433 ,1843 ,123 ,185 ,369 
2018/12/26,30,22,8,1652,2470,8969,2881,2874,6181,4533 ,5344 ,15150 ,75 ,112 ,408 ,360 ,359 ,773 
2018/12/27,30,24,6,105257,22911,74300,3114,1868,1988,108371 ,24779 ,76288 ,4386 ,955 ,3096 ,519 ,311 ,331 
2018/12/28,30,26,4,10039,8795,37650,629,900,2187,10668 ,9695 ,39837 ,386 ,338 ,1448 ,157 ,225 ,547 
2018/12/29,30,26,4,22463,12709,20655,1471,8217,9100,23934 ,20926 ,29755 ,864 ,489 ,794 ,368 ,2054 ,2275 
2018/12/30,29,20,9,1640,5497,5630,425,619,1009,2065 ,6116 ,6639 ,82 ,275 ,282 ,47 ,69 ,112 
2018/12/31,20,10,10,8426,6077,14534,3177,1941,3925,11603 ,8018 ,18459 ,843 ,608 ,1453 ,318 ,194 ,393 
2019/1/1,28,18,10,56864,22478,14477,826,2079,2562,57690 ,24557 ,17039 ,3159 ,1249 ,804 ,83 ,208 ,256 
2019/1/2,30,11,19,2288,3890,6697,5160,13913,17978,7448 ,17803 ,24675 ,208 ,354 ,609 ,272 ,732 ,946 
2019/1/3,30,16,14,7113,7697,6788,2872,4386,5249,9985 ,12083 ,12037 ,445 ,481 ,424 ,205 ,313 ,375 
2019/1/4,30,15,15,2425,3052,5289,3213,7043,8692,5638 ,10095 ,13981 ,162 ,203 ,353 ,214 ,470 ,579 
2019/1/5,28,18,10,9503,10685,8133,684,1436,1858,10187 ,12121 ,9991 ,528 ,594 ,452 ,68 ,144 ,186 
2019/1/6,30,18,12,1981,5399,5280,304,1301,1755,2285 ,6700 ,7035 ,110 ,300 ,293 ,25 ,108 ,146 
2019/1/7,30,26,4,10812,18084,139000,207,1165,766,11019 ,19249 ,139766 ,416 ,696 ,5346 ,52 ,291 ,192 
2019/1/8,30,19,11,3451,8048,13272,1814,4226,5902,5265 ,12274 ,19174 ,182 ,424 ,699 ,165 ,384 ,537 
2019/1/9,30,17,13,821,1994,5051,2316,9493,8089,3137 ,11487 ,13140 ,48 ,117 ,297 ,178 ,730 ,622 
2019/1/10,30,9,21,7650,5785,16151,5121,11697,8873,12771 ,17482 ,25024 ,850 ,643 ,1795 ,244 ,557 ,423 
2019/1/11,30,8,22,34131,9043,46130,14774,12716,13553,48905 ,21759 ,59683 ,4266 ,1130 ,5766 ,672 ,578 ,616 
2019/1/12,30,6,24,711,2169,3607,11492,14841,24312,12203 ,17010 ,27919 ,119 ,362 ,601 ,479 ,618 ,1013 
2019/1/13,29,7,22,364,1046,912,3048,6857,6538,3412 ,7903 ,7450 ,52 ,149 ,130 ,139 ,312 ,297 
2019/1/14,30,24,6,22726,7582,17236,1286,1293,3150,24012 ,8875 ,20386 ,947 ,316 ,718 ,214 ,216 ,525 
2019/1/15,30,22,8,19932,14394,11603,4965,1325,2001,24897 ,15719 ,13604 ,906 ,654 ,527 ,621 ,166 ,250 
2019/1/16,30,16,14,11376,7602,7866,991,2756,4408,12367 ,10358 ,12274 ,711 ,475 ,492 ,71 ,197 ,315 
2019/1/17,30,23,7,13029,10503,25035,2510,2218,3685,15539 ,12721 ,28720 ,566 ,457 ,1088 ,359 ,317 ,526 
2019/1/18,30,21,9,3703,5704,16400,2128,2414,7225,5831 ,8118 ,23625 ,176 ,272 ,781 ,236 ,268 ,803 
2019/1/19,30,16,14,2162,1192,2448,1125,3069,2162,3287 ,4261 ,4610 ,135 ,75 ,153 ,80 ,219 ,154 
2019/1/20,30,15,15,4453,5638,12307,28063,12441,256633,32516 ,18079 ,268940 ,297 ,376 ,820 ,1871 ,829 ,17109 
2019/1/21,30,12,18,3909,2629,11930,12036,7132,13991,15945 ,9761 ,25921 ,326 ,219 ,994 ,669 ,396 ,777 
2019/1/22,30,19,11,5446,6330,10417,5184,7549,11844,10630 ,13879 ,22261 ,287 ,333 ,548 ,471 ,686 ,1077 
2019/1/23,30,18,12,2231,4054,5445,1483,1334,2396,3714 ,5388 ,7841 ,124 ,225 ,303 ,124 ,111 ,200 
2019/1/24,30,28,2,4069,7337,24797,378,440,1902,4447 ,7777 ,26699 ,145 ,262 ,886 ,189 ,220 ,951 
2019/1/25,30,19,11,8186,7793,7727,2091,2140,3517,10277 ,9933 ,11244 ,431 ,410 ,407 ,190 ,195 ,320 
2019/1/26,30,21,9,26894,9487,6610,1132,1719,2230,28026 ,11206 ,8840 ,1281 ,452 ,315 ,126 ,191 ,248 
2019/1/27,30,19,11,1763,2909,4823,762,1950,2792,2525 ,4859 ,7615 ,93 ,153 ,254 ,69 ,177 ,254 
2019/1/28,30,26,4,7257,6563,18175,700,999,1009,7957 ,7562 ,19184 ,279 ,252 ,699 ,175 ,250 ,252 
2019/1/29,30,14,16,4667,6421,14703,3920,9982,10673,8587 ,16403 ,25376 ,333 ,459 ,1050 ,245 ,624 ,667 
2019/1/30,30,19,11,4742,3577,6629,2475,1826,3554,7217 ,5403 ,10183 ,250 ,188 ,349 ,225 ,166 ,323 
2019/1/31,30,22,8,3134,4358,8519,1509,1829,2207,4643 ,6187 ,10726 ,142 ,198 ,387 ,189 ,229 ,276 
2019/2/1,30,24,6,21446,11346,14319,555,772,1620,22001 ,12118 ,15939 ,894 ,473 ,597 ,93 ,129 ,270 
2019/2/2,30,26,4,15740,13522,26365,968,1111,7035,16708 ,14633 ,33400 ,605 ,520 ,1014 ,242 ,278 ,1759 
2019/2/3,30,23,7,2051,2365,3929,2331,1122,3137,4382 ,3487 ,7066 ,89 ,103 ,171 ,333 ,160 ,448 
2019/2/4,28,18,10,12039,14087,9982,2719,2228,2442,14758 ,16315 ,12424 ,669 ,783 ,555 ,272 ,223 ,244 
2019/2/5,25,19,6,3642,4802,5729,442,267,2422,4084 ,5069 ,8151 ,192 ,253 ,302 ,74 ,45 ,404 
2019/2/6,30,16,14,1920,1987,2469,843,1836,2644,2763 ,3823 ,5113 ,120 ,124 ,154 ,60 ,131 ,189 
2019/2/7,30,23,7,2564,2708,4658,220,482,573,2784 ,3190 ,5231 ,111 ,118 ,203 ,31 ,69 ,82 
2019/2/8,25,18,7,1488,4144,9086,1325,914,1456,2813 ,5058 ,10542 ,83 ,230 ,505 ,189 ,131 ,208 
2019/2/9,30,23,7,1265,1915,6353,206,382,833,1471 ,2297 ,7186 ,55 ,83 ,276 ,29 ,55 ,119 
2019/2/10,25,18,7,630,2952,3974,149,825,587,779 ,3777 ,4561 ,35 ,164 ,221 ,21 ,118 ,84 
2019/2/11,30,25,5,135531,197177,251744,4425,13026,10125,139956 ,210203 ,261869 ,5421 ,7887 ,10070 ,885 ,2605 ,2025 
2019/2/12,30,18,12,1289,2400,3845,2797,3037,11597,4086 ,5437 ,15442 ,72 ,133 ,214 ,233 ,253 ,966 
2019/2/13,30,21,9,28244,194450,235022,1538,2255,9996,29782 ,196705 ,245018 ,1345 ,9260 ,11192 ,171 ,251 ,1111 
2019/2/14,30,19,11,5953,7727,13080,671,2316,4681,6624 ,10043 ,17761 ,313 ,407 ,688 ,61 ,211 ,426 
2019/2/15,30,21,9,4569,3514,7690,636,869,2291,5205 ,4383 ,9981 ,218 ,167 ,366 ,71 ,97 ,255 
2019/2/16,30,15,15,1153,1463,2593,890,1899,3738,2043 ,3362 ,6331 ,77 ,98 ,173 ,59 ,127 ,249 
2019/2/17,30,15,15,1267,1454,2078,740,1121,1293,2007 ,2575 ,3371 ,84 ,97 ,139 ,49 ,75 ,86 
2019/2/18,30,20,10,1383,2837,9694,937,619,1276,2320 ,3456 ,10970 ,69 ,142 ,485 ,94 ,62 ,128 
2019/2/19,30,24,6,23085,16315,27342,638,1308,3281,23723 ,17623 ,30623 ,962 ,680 ,1139 ,106 ,218 ,547 
2019/2/20,30,14,16,2318,4129,6978,2678,7807,7780,4996 ,11936 ,14758 ,166 ,295 ,498 ,167 ,488 ,486 
2019/2/21,30,20,10,1267,3918,7473,3838,2438,12305,5105 ,6356 ,19778 ,63 ,196 ,374 ,384 ,244 ,1231 
2019/2/22,30,19,11,1452,2270,4150,945,1068,2526,2397 ,3338 ,6676 ,76 ,119 ,218 ,86 ,97 ,230 
2019/2/27,28,20,8,2000,5358,5484,820,1121,2595,2820 ,6479 ,8079 ,100 ,268 ,274 ,103 ,140 ,324 
2019/2/28,30,20,10,3290,2563,8503,1771,3335,2283,5061 ,5898 ,10786 ,165 ,128 ,425 ,177 ,334 ,228 
2019/3/1,30,16,14,1509,1977,4059,1820,2575,2462,3329 ,4552 ,6521 ,94 ,124 ,254 ,130 ,184 ,176 
2019/3/2,30,12,18,31265,7470,11665,1646,3525,4292,32911 ,10995 ,15957 ,2605 ,623 ,972 ,91 ,196 ,238 
2019/3/3,21,11,10,626,1218,1612,631,900,1817,1257 ,2118 ,3429 ,57 ,111 ,147 ,63 ,90 ,182 
2019/3/4,30,16,14,3494,5997,22212,3178,6080,12467,6672 ,12077 ,34679 ,218 ,375 ,1388 ,227 ,434 ,891 
2019/3/5,30,23,7,1759,3481,7688,149,816,758,1908 ,4297 ,8446 ,76 ,151 ,334 ,21 ,117 ,108 
2019/3/6,30,18,12,110459,7639,19992,539,1700,5125,110998 ,9339 ,25117 ,6137 ,424 ,1111 ,45 ,142 ,427 
2019/3/7,30,18,12,81399,57171,320605,57757,48857,242195,139156 ,106028 ,562800 ,4522 ,3176 ,17811 ,4813 ,4071 ,20183 
2019/3/8,30,18,12,14623,12209,13132,2078,2326,6411,16701 ,14535 ,19543 ,812 ,678 ,730 ,173 ,194 ,534 
2019/3/9,30,17,13,1176,2143,5112,1780,2147,5589,2956 ,4290 ,10701 ,69 ,126 ,301 ,137 ,165 ,430 
2019/3/10,30,10,20,1362,1391,1432,3371,4553,10361,4733 ,5944 ,11793 ,136 ,139 ,143 ,169 ,228 ,518 
2019/3/11,30,23,7,4893,9919,15266,321,475,875,5214 ,10394 ,16141 ,213 ,431 ,664 ,46 ,68 ,125 
2019/3/12,30,12,18,1148,2315,4420,2784,6984,13948,3932 ,9299 ,18368 ,96 ,193 ,368 ,155 ,388 ,775 
2019/3/13,30,18,12,98278,39628,75232,2442,3917,6611,100720 ,43545 ,81843 ,5460 ,2202 ,4180 ,204 ,326 ,551 
2019/3/14,30,12,18,7587,3607,7572,1225,7305,11123,8812 ,10912 ,18695 ,632 ,301 ,631 ,68 ,406 ,618 
2019/3/15,30,19,11,20883,8900,24421,723,2571,2523,21606 ,11471 ,26944 ,1099 ,468 ,1285 ,66 ,234 ,229 
2019/3/16,29,18,11,2080,2991,9563,7502,2831,34709,9582 ,5822 ,44272 ,116 ,166 ,531 ,682 ,257 ,3155 
2019/3/17,27,20,7,4232,4421,7480,239,1294,1242,4471 ,5715 ,8722 ,212 ,221 ,374 ,34 ,185 ,177 
2019/3/18,30,20,10,1007,1520,3637,11635,4367,4736,12642 ,5887 ,8373 ,50 ,76 ,182 ,1164 ,437 ,474 
2019/3/19,30,26,4,38798,39050,40309,6736,5456,2875,45534 ,44506 ,43184 ,1492 ,1502 ,1550 ,1684 ,1364 ,719 
2019/3/20,30,27,3,15590,11664,26343,823,1021,1719,16413 ,12685 ,28062 ,577 ,432 ,976 ,274 ,340 ,573 
2019/3/21,30,23,7,2415,3169,6287,8986,2763,6532,11401 ,5932 ,12819 ,105 ,138 ,273 ,1284 ,395 ,933 
2019/3/22,30,23,7,9188,7820,9263,569,1305,2968,9757 ,9125 ,12231 ,399 ,340 ,403 ,81 ,186 ,424 
2019/3/23,29,21,8,8432,2731,5568,681,3319,2614,9113 ,6050 ,8182 ,402 ,130 ,265 ,85 ,415 ,327 
2019/3/24,30,19,11,1753,4650,5049,1389,2788,5908,3142 ,7438 ,10957 ,92 ,245 ,266 ,126 ,253 ,537 
2019/3/25,30,21,9,4499,5478,12695,6681,12286,7976,11180 ,17764 ,20671 ,214 ,261 ,605 ,742 ,1365 ,886 
2019/3/26,30,29,1,63913,42845,165794,48,147,240,63961 ,42992 ,166034 ,2204 ,1477 ,5717 ,48 ,147 ,240 
2019/3/27,30,23,7,23349,37815,38933,2687,4796,9809,26036 ,42611 ,48742 ,1015 ,1644 ,1693 ,384 ,685 ,1401 
2019/3/28,29,20,9,5172,8249,10802,1083,2889,8770,6255 ,11138 ,19572 ,259 ,412 ,540 ,120 ,321 ,974 
2019/3/29,30,17,13,12382,3220,8070,2400,3852,5984,14782 ,7072 ,14054 ,728 ,189 ,475 ,185 ,296 ,460 
2019/3/30,30,16,14,6801,6156,6600,1832,4839,6323,8633 ,10995 ,12923 ,425 ,385 ,413 ,131 ,346 ,452 
2019/3/31,30,15,15,1584,2381,6048,1265,2538,3978,2849 ,4919 ,10026 ,106 ,159 ,403 ,84 ,169 ,265 
2019/4/1,30,19,11,981,2561,12277,705,1878,5123,1686 ,4439 ,17400 ,52 ,135 ,646 ,64 ,171 ,466 
2019/4/2,30,23,7,162517,10612,20323,530,1015,3305,163047 ,11627 ,23628 ,7066 ,461 ,884 ,76 ,145 ,472 
2019/4/3,30,23,7,14222,11202,14769,321,791,1616,14543 ,11993 ,16385 ,618 ,487 ,642 ,46 ,113 ,231 
2019/4/4,30,20,10,6496,10040,12780,948,2510,4698,7444 ,12550 ,17478 ,325 ,502 ,639 ,95 ,251 ,470 
2019/4/5,30,20,10,3022,3404,9318,783,1670,2304,3805 ,5074 ,11622 ,151 ,170 ,466 ,78 ,167 ,230 
2019/4/6,30,16,14,2049,3674,6596,1589,3938,9465,3638 ,7612 ,16061 ,128 ,230 ,412 ,114 ,281 ,676 
2019/4/7,27,12,15,21774,8982,14478,1126,2637,4681,22900 ,11619 ,19159 ,1815 ,749 ,1207 ,75 ,176 ,312 
2019/4/8,28,19,9,1625,4082,10262,352,1698,2293,1977 ,5780 ,12555 ,86 ,215 ,540 ,39 ,189 ,255 
2019/4/9,30,20,10,22544,10986,16809,1210,6959,12591,23754 ,17945 ,29400 ,1127 ,549 ,840 ,121 ,696 ,1259 
2019/4/10,28,20,8,3429,5441,10399,5072,1983,3810,8501 ,7424 ,14209 ,171 ,272 ,520 ,634 ,248 ,476 
2019/4/11,30,30,0,176971,69285,227807,0,0,0,176971 ,69285 ,227807 ,5899 ,2310 ,7594 ,#DIV/0!,#DIV/0!,#DIV/0!
2019/4/12,28,23,5,5794,5500,27005,406,2250,4326,6200 ,7750 ,31331 ,252 ,239 ,1174 ,81 ,450 ,865 
2019/4/13,26,15,11,23106,15557,17140,1236,6374,8450,24342 ,21931 ,25590 ,1540 ,1037 ,1143 ,112 ,579 ,768 
2019/4/14,27,16,11,16106,13458,11527,414,2259,2992,16520 ,15717 ,14519 ,1007 ,841 ,720 ,38 ,205 ,272 
2019/4/15,30,19,11,6248,8135,9836,1149,2992,3637,7397 ,11127 ,13473 ,329 ,428 ,518 ,104 ,272 ,331 
2019/4/16,30,21,9,13732,14524,32233,753,2520,2847,14485 ,17044 ,35080 ,654 ,692 ,1535 ,84 ,280 ,316 
2019/4/17,30,18,12,11224,10642,33317,2734,6445,7089,13958 ,17087 ,40406 ,624 ,591 ,1851 ,228 ,537 ,591 
2019/4/18,30,16,14,2193,2862,9907,4957,5004,10259,7150 ,7866 ,20166 ,137 ,179 ,619 ,354 ,357 ,733 
2019/4/19,29,18,11,2313,3400,5125,771,1841,3436,3084 ,5241 ,8561 ,129 ,189 ,285 ,70 ,167 ,312 
2019/4/20,28,20,8,2698,8174,7829,353,2002,4227,3051 ,10176 ,12056 ,135 ,409 ,391 ,44 ,250 ,528 
2019/4/21,30,23,7,4588,3833,13210,1086,3322,6630,5674 ,7155 ,19840 ,199 ,167 ,574 ,155 ,475 ,947 
2019/4/22,30,23,7,20709,16036,20008,732,3422,5578,21441 ,19458 ,25586 ,900 ,697 ,870 ,105 ,489 ,797 
2019/4/23,30,20,10,8817,6889,15869,663,4764,6754,9480 ,11653 ,22623 ,441 ,344 ,793 ,66 ,476 ,675 
2019/4/24,30,22,8,46596,23645,30094,723,2714,2480,47319 ,26359 ,32574 ,2118 ,1075 ,1368 ,90 ,339 ,310 
2019/4/25,30,22,8,8856,11013,14761,581,2345,3805,9437 ,13358 ,18566 ,403 ,501 ,671 ,73 ,293 ,476 
2019/4/26,10,5,5,235,394,1153,260,914,1656,495 ,1308 ,2809 ,47 ,79 ,231 ,52 ,183 ,331 
2019/4/28,30,23,7,5241,7036,10916,273,2599,1672,5514 ,9635 ,12588 ,228 ,306 ,475 ,39 ,371 ,239 
2019/4/29,29,21,8,29690,33288,68386,1029,2581,5614,30719 ,35869 ,74000 ,1414 ,1585 ,3256 ,129 ,323 ,702 
2019/4/30,30,24,6,13990,11454,18036,1969,2848,1702,15959 ,14302 ,19738 ,583 ,477 ,752 ,328 ,475 ,284 
2019/5/1,27,16,11,3680,3032,6447,289,4259,3722,3969 ,7291 ,10169 ,230 ,190 ,403 ,26 ,387 ,338 
2019/5/2,30,13,17,1309,2605,3281,1300,1928,6642,2609 ,4533 ,9923 ,101 ,200 ,252 ,76 ,113 ,391 
2019/5/3,30,18,12,2482,3871,18297,600,1397,4480,3082 ,5268 ,22777 ,138 ,215 ,1017 ,50 ,116 ,373 
2019/5/4,28,18,10,6495,6449,10940,1535,3246,7647,8030 ,9695 ,18587 ,361 ,358 ,608 ,154 ,325 ,765 
2019/5/5,27,21,6,27476,14107,15213,949,1877,1604,28425 ,15984 ,16817 ,1308 ,672 ,724 ,158 ,313 ,267 
2019/5/6,30,24,6,18753,22431,22816,434,678,711,19187 ,23109 ,23527 ,781 ,935 ,951 ,72 ,113 ,119 
2019/5/7,30,26,4,24502,18691,21535,138,1223,2550,24640 ,19914 ,24085 ,942 ,719 ,828 ,35 ,306 ,638 
2019/5/8,30,18,12,65378,10071,14698,870,2334,2653,66248 ,12405 ,17351 ,3632 ,560 ,817 ,73 ,195 ,221 
2019/5/9,30,17,13,8488,6045,11696,4182,4293,15701,12670 ,10338 ,27397 ,499 ,356 ,688 ,322 ,330 ,1208 
2019/5/10,30,19,11,16106,12982,19753,2164,6562,16604,18270 ,19544 ,36357 ,848 ,683 ,1040 ,197 ,597 ,1509 
2019/5/11,30,22,8,2740,3266,8117,835,3068,3943,3575 ,6334 ,12060 ,125 ,148 ,369 ,104 ,384 ,493 
2019/5/12,29,18,11,2158,5366,4374,331,4198,5959,2489 ,9564 ,10333 ,120 ,298 ,243 ,30 ,382 ,542 
2019/5/13,30,23,7,6390,6483,42845,603,1641,16287,6993 ,8124 ,59132 ,278 ,282 ,1863 ,86 ,234 ,2327 
2019/5/14,30,26,4,10140,12320,20216,1569,2204,1903,11709 ,14524 ,22119 ,390 ,474 ,778 ,392 ,551 ,476 
2019/5/15,30,26,4,23615,26607,13966,430,628,2001,24045 ,27235 ,15967 ,908 ,1023 ,537 ,108 ,157 ,500 
2019/5/16,30,18,12,11804,19953,52344,5383,7648,8609,17187 ,27601 ,60953 ,656 ,1109 ,2908 ,449 ,637 ,717 
2019/5/17,30,23,7,134010,75928,564168,12688,13594,72954,146698 ,89522 ,637122 ,5827 ,3301 ,24529 ,1813 ,1942 ,10422 
2019/5/18,30,19,11,8423,9502,54630,5329,4456,17865,13752 ,13958 ,72495 ,443 ,500 ,2875 ,484 ,405 ,1624 
2019/5/19,30,18,12,7154,13202,39843,6642,6499,12535,13796 ,19701 ,52378 ,397 ,733 ,2214 ,554 ,542 ,1045 
2019/5/20,30,17,13,9358,24942,64558,10572,17720,65254,19930 ,42662 ,129812 ,550 ,1467 ,3798 ,813 ,1363 ,5020 
2019/5/21,30,22,8,80191,35908,492533,13440,7002,50350,93631 ,42910 ,542883 ,3645 ,1632 ,22388 ,1680 ,875 ,6294 
2019/5/22,30,23,7,37829,29792,170461,3539,4018,14089,41368 ,33810 ,184550 ,1645 ,1295 ,7411 ,506 ,574 ,2013 
2019/5/23,30,23,7,90827,101343,199853,13650,12386,71230,104477 ,113729 ,271083 ,3949 ,4406 ,8689 ,1950 ,1769 ,10176 
2019/5/24,30,19,11,59636,21074,137873,11905,10831,75908,71541 ,31905 ,213781 ,3139 ,1109 ,7256 ,1082 ,985 ,6901 
2019/5/25,30,15,15,10776,15655,156982,14588,6998,72173,25364 ,22653 ,229155 ,718 ,1044 ,10465 ,973 ,467 ,4812 
2019/5/26,30,16,14,72707,31267,796972,13961,18656,53746,86668 ,49923 ,850718 ,4544 ,1954 ,49811 ,997 ,1333 ,3839 
2019/5/27,30,14,16,22391,8336,58912,36197,11248,79658,58588 ,19584 ,138570 ,1599 ,595 ,4208 ,2262 ,703 ,4979 
2019/5/28,30,22,8,99531,35791,288611,22920,87598,36627,122451 ,123389 ,325238 ,4524 ,1627 ,13119 ,2865 ,10950 ,4578 
2019/5/29,30,24,6,24641,24949,195389,6455,4945,15123,31096 ,29894 ,210512 ,1027 ,1040 ,8141 ,1076 ,824 ,2521 
2019/5/30,30,18,12,6938,6104,64063,5865,4901,74457,12803 ,11005 ,138520 ,385 ,339 ,3559 ,489 ,408 ,6205 
2019/5/31,30,26,4,20168,9556,286438,760,590,4221,20928 ,10146 ,290659 ,776 ,368 ,11017 ,190 ,148 ,1055 
2019/6/1,30,26,4,45444,16435,258786,932,1300,16560,46376 ,17735 ,275346 ,1748 ,632 ,9953 ,233 ,325 ,4140 
2019/6/2,30,19,11,40169,15626,130414,6243,3875,43514,46412 ,19501 ,173928 ,2114 ,822 ,6864 ,568 ,352 ,3956 
2019/6/3,30,24,6,8389,7256,34705,579,1189,5341,8968 ,8445 ,40046 ,350 ,302 ,1446 ,97 ,198 ,890 
2019/6/4,30,15,15,4688,3103,23746,3558,5824,126468,8246 ,8927 ,150214 ,313 ,207 ,1583 ,237 ,388 ,8431 
2019/6/5,30,27,3,19942,25604,774171,290,790,7082,20232 ,26394 ,781253 ,739 ,948 ,28673 ,97 ,263 ,2361 
2019/6/6,30,26,4,23364,15718,209312,413,753,10025,23777 ,16471 ,219337 ,899 ,605 ,8050 ,103 ,188 ,2506 
2019/6/7,30,18,12,12577,10550,48223,1852,3286,20144,14429 ,13836 ,68367 ,699 ,586 ,2679 ,154 ,274 ,1679 
2019/6/8,30,26,4,5673,3886,40927,555,1098,5483,6228 ,4984 ,46410 ,218 ,149 ,1574 ,139 ,275 ,1371 
2019/6/9,30,20,10,5226,6058,61049,1251,4702,22431,6477 ,10760 ,83480 ,261 ,303 ,3052 ,125 ,470 ,2243 
2019/6/10,30,26,4,12718,11342,113161,1016,4457,31698,13734 ,15799 ,144859 ,489 ,436 ,4352 ,254 ,1114 ,7925 
2019/6/11,30,28,2,37279,18852,395125,741,1970,9644,38020 ,20822 ,404769 ,1331 ,673 ,14112 ,371 ,985 ,4822 
2019/6/12,30,20,10,7420,3432,29597,1622,2376,18220,9042 ,5808 ,47817 ,371 ,172 ,1480 ,162 ,238 ,1822 
2019/6/13,30,19,11,3805,4032,60488,4366,2957,33709,8171 ,6989 ,94197 ,200 ,212 ,3184 ,397 ,269 ,3064 
2019/6/14,30,26,4,69343,20213,85052,2190,1625,13033,71533 ,21838 ,98085 ,2667 ,777 ,3271 ,548 ,406 ,3258 
2019/6/15,30,23,7,4956,7565,65272,593,1664,11565,5549 ,9229 ,76837 ,215 ,329 ,2838 ,85 ,238 ,1652 
2019/6/16,30,15,15,1649,7077,40073,5155,10765,71074,6804 ,17842 ,111147 ,110 ,472 ,2672 ,344 ,718 ,4738 
2019/6/17,30,24,6,18561,833288,1805263,9899,3335,23364,28460 ,836623 ,1828627 ,773 ,34720 ,75219 ,1650 ,556 ,3894 
2019/6/18,30,29,1,20521,20832,201836,50,198,17227,20571 ,21030 ,219063 ,708 ,718 ,6960 ,50 ,198 ,17227 
2019/6/19,30,20,10,12117,6660,55615,5314,4191,23940,17431 ,10851 ,79555 ,606 ,333 ,2781 ,531 ,419 ,2394 
2019/6/20,30,18,12,26017,7408,62687,3516,5261,38191,29533 ,12669 ,100878 ,1445 ,412 ,3483 ,293 ,438 ,3183 
2019/6/21,30,26,4,97772,80591,359701,5521,2451,31288,103293 ,83042 ,390989 ,3760 ,3100 ,13835 ,1380 ,613 ,7822 
2019/6/22,30,22,8,12971,7358,78560,1110,3319,16475,14081 ,10677 ,95035 ,590 ,334 ,3571 ,139 ,415 ,2059 
2019/6/23,30,20,10,4473,4277,45101,1817,3170,33203,6290 ,7447 ,78304 ,224 ,214 ,2255 ,182 ,317 ,3320 
2019/6/24,30,13,17,1384,2866,12862,1449,3976,22381,2833 ,6842 ,35243 ,106 ,220 ,989 ,85 ,234 ,1317 
2019/6/25,30,28,2,9805,13439,99251,250,183,2086,10055 ,13622 ,101337 ,350 ,480 ,3545 ,125 ,92 ,1043 
2019/6/26,30,19,11,6741,6770,38969,3734,3238,32867,10475 ,10008 ,71836 ,355 ,356 ,2051 ,339 ,294 ,2988 
2019/6/27,30,24,6,6658,14415,328443,10544,4006,44885,17202 ,18421 ,373328 ,277 ,601 ,13685 ,1757 ,668 ,7481 
2019/6/28,30,27,3,11222,11087,159289,3073,4632,74909,14295 ,15719 ,234198 ,416 ,411 ,5900 ,1024 ,1544 ,24970 
2019/6/29,30,26,4,23751,19480,240389,437,517,6855,24188 ,19997 ,247244 ,914 ,749 ,9246 ,109 ,129 ,1714 
2019/6/30,30,18,12,3974,3879,17827,4155,8061,48298,8129 ,11940 ,66125 ,221 ,216 ,990 ,346 ,672 ,4025 
2019/7/1,30,20,10,2419,1851,10206,640,2132,8416,3059 ,3983 ,18622 ,121 ,93 ,510 ,64 ,213 ,842 
2019/7/2,30,26,4,6437,7886,32727,434,2807,11055,6871 ,10693 ,43782 ,248 ,303 ,1259 ,109 ,702 ,2764 
2019/7/3,30,25,5,3668,3026,12938,641,2749,12609,4309 ,5775 ,25547 ,147 ,121 ,518 ,128 ,550 ,2522 
2019/7/4,30,18,12,1300,3046,9307,477,1582,9231,1777 ,4628 ,18538 ,72 ,169 ,517 ,40 ,132 ,769 
2019/7/5,30,21,9,1350,1661,9933,733,874,4871,2083 ,2535 ,14804 ,64 ,79 ,473 ,81 ,97 ,541 
2019/7/6,30,22,8,15873,19729,68620,1064,2092,11240,16937 ,21821 ,79860 ,722 ,897 ,3119 ,133 ,262 ,1405 
2019/7/7,30,16,14,1850,1971,10456,3805,5623,36597,5655 ,7594 ,47053 ,116 ,123 ,654 ,272 ,402 ,2614 
2019/7/8,30,16,14,5647,4318,47864,152361,149796,185024,158008 ,154114 ,232888 ,353 ,270 ,2992 ,10883 ,10700 ,13216 
2019/7/9,30,19,11,10774,12891,44686,5038,5423,49330,15812 ,18314 ,94016 ,567 ,678 ,2352 ,458 ,493 ,4485 
2019/7/10,30,23,7,5569,14720,82954,1912,2622,35750,7481 ,17342 ,118704 ,242 ,640 ,3607 ,273 ,375 ,5107 
2019/7/11,30,22,8,9698,6959,67004,1000,1020,9068,10698 ,7979 ,76072 ,441 ,316 ,3046 ,125 ,128 ,1134 
2019/7/12,30,20,10,2666,3626,20288,294,796,9313,2960 ,4422 ,29601 ,133 ,181 ,1014 ,29 ,80 ,931 
2019/7/13,30,13,17,2266,3752,15421,1201,3669,23376,3467 ,7421 ,38797 ,174 ,289 ,1186 ,71 ,216 ,1375 
2019/7/14,30,19,11,2150,4692,30803,1361,2852,38181,3511 ,7544 ,68984 ,113 ,247 ,1621 ,124 ,259 ,3471 
2019/7/15,30,20,10,5687,4642,47306,14975,7004,35680,20662 ,11646 ,82986 ,284 ,232 ,2365 ,1498 ,700 ,3568 
2019/7/16,30,23,7,2812,4660,24949,10715,3225,18446,13527 ,7885 ,43395 ,122 ,203 ,1085 ,1531 ,461 ,2635 
2019/7/17,30,28,2,9039,25293,599104,162,414,4014,9201 ,25707 ,603118 ,323 ,903 ,21397 ,81 ,207 ,2007 
2019/7/18,30,18,12,3798,5127,33364,1865,2174,15604,5663 ,7301 ,48968 ,211 ,285 ,1854 ,155 ,181 ,1300 
2019/7/19,30,23,7,12868,8369,78275,919,2007,7148,13787 ,10376 ,85423 ,559 ,364 ,3403 ,131 ,287 ,1021 
2019/7/20,30,19,11,14589,3865,26875,531,2284,12594,15120 ,6149 ,39469 ,768 ,203 ,1414 ,48 ,208 ,1145 
2019/7/21,30,23,7,1605,1334,5499,537,1322,5631,2142 ,2656 ,11130 ,70 ,58 ,239 ,77 ,189 ,804 
2019/7/22,30,25,5,12095,11923,131532,268,1906,16213,12363 ,13829 ,147745 ,484 ,477 ,5261 ,54 ,381 ,3243 
2019/7/23,30,27,3,15745,15692,348198,52,232,34930,15797 ,15924 ,383128 ,583 ,581 ,12896 ,17 ,77 ,11643 
2019/7/24,30,23,7,3606,6019,49780,1067,1810,56911,4673 ,7829 ,106691 ,157 ,262 ,2164 ,152 ,259 ,8130 
2019/7/25,30,20,10,10669,10051,108383,4074,3559,48857,14743 ,13610 ,157240 ,533 ,503 ,5419 ,407 ,356 ,4886 
2019/7/26,30,13,17,3866,6646,49237,10156,14866,498279,14022 ,21512 ,547516 ,297 ,511 ,3787 ,597 ,874 ,29311 
2019/7/27,30,20,10,4500,6145,22203,769,2547,22567,5269 ,8692 ,44770 ,225 ,307 ,1110 ,77 ,255 ,2257 
2019/7/28,30,15,15,2085,2418,8325,1783,3222,46163,3868 ,5640 ,54488 ,139 ,161 ,555 ,119 ,215 ,3078 
2019/7/29,30,19,11,1357,3273,26129,980,1764,42112,2337 ,5037 ,68241 ,71 ,172 ,1375 ,89 ,160 ,3828 
2019/7/30,30,15,15,865,2181,16304,1309,3781,39533,2174 ,5962 ,55837 ,58 ,145 ,1087 ,87 ,252 ,2636 
2019/7/31,30,20,10,2793,3853,15967,1304,2635,11561,4097 ,6488 ,27528 ,140 ,193 ,798 ,130 ,264 ,1156 
2019/8/1,30,14,16,17848,10935,18421,889,2541,12348,18737 ,13476 ,30769 ,1275 ,781 ,1316 ,56 ,159 ,772 
2019/8/2,30,22,8,3807,13242,47258,717,1859,12096,4524 ,15101 ,59354 ,173 ,602 ,2148 ,90 ,232 ,1512 
2019/8/3,30,22,8,2590,2852,21068,135,1214,13085,2725 ,4066 ,34153 ,118 ,130 ,958 ,17 ,152 ,1636 
2019/8/4,30,21,9,1225,1581,9812,372,1463,9900,1597 ,3044 ,19712 ,58 ,75 ,467 ,41 ,163 ,1100 
2019/8/5,30,19,11,7777,4367,27817,440,2699,12853,8217 ,7066 ,40670 ,409 ,230 ,1464 ,40 ,245 ,1168 
2019/8/6,30,21,9,12229,6048,39863,702,2926,22162,12931 ,8974 ,62025 ,582 ,288 ,1898 ,78 ,325 ,2462 
2019/8/7,30,18,12,1498,2480,9343,1342,2475,19880,2840 ,4955 ,29223 ,83 ,138 ,519 ,112 ,206 ,1657 
2019/8/8,30,26,4,5527,10416,118722,259,1124,22878,5786 ,11540 ,141600 ,213 ,401 ,4566 ,65 ,281 ,5720 
2019/8/9,30,28,2,81961,58604,1632650,161,545,49389,82122 ,59149 ,1682039 ,2927 ,2093 ,58309 ,81 ,273 ,24695 
2019/8/10,30,25,5,7803,8914,124602,590,1230,93018,8393 ,10144 ,217620 ,312 ,357 ,4984 ,118 ,246 ,18604 
2019/8/11,30,23,7,7452,7554,52307,1374,2117,23298,8826 ,9671 ,75605 ,324 ,328 ,2274 ,196 ,302 ,3328 
2019/8/12,30,20,10,2417,4240,36447,4071,3160,18145,6488 ,7400 ,54592 ,121 ,212 ,1822 ,407 ,316 ,1815 
2019/8/13,30,14,16,2329,9536,63548,3358,8780,82462,5687 ,18316 ,146010 ,166 ,681 ,4539 ,210 ,549 ,5154 
2019/8/14,30,21,9,21630,22335,964972,2546,4080,32456,24176 ,26415 ,997428 ,1030 ,1064 ,45951 ,283 ,453 ,3606 
2019/8/15,30,25,5,4113,3737,130301,401,445,5605,4514 ,4182 ,135906 ,165 ,149 ,5212 ,80 ,89 ,1121 
2019/8/16,30,25,5,18369,12716,60597,225,906,15887,18594 ,13622 ,76484 ,735 ,509 ,2424 ,45 ,181 ,3177 
2019/8/17,30,15,15,9905,4243,61373,5331,6957,79358,15236 ,11200 ,140731 ,660 ,283 ,4092 ,355 ,464 ,5291 
2019/8/18,30,14,16,2414,3165,51616,1948,3552,53928,4362 ,6717 ,105544 ,172 ,226 ,3687 ,122 ,222 ,3371 
2019/8/19,30,17,13,24198,14791,196966,1558,2227,36889,25756 ,17018 ,233855 ,1423 ,870 ,11586 ,120 ,171 ,2838 
2019/8/20,30,13,17,3108,4234,63848,3681,4403,56858,6789 ,8637 ,120706 ,239 ,326 ,4911 ,217 ,259 ,3345 
2019/8/21,30,24,6,23649,11303,84929,5382,3553,66756,29031 ,14856 ,151685 ,985 ,471 ,3539 ,897 ,592 ,11126 
2019/8/22,30,26,4,11134,16274,185064,1322,1542,21279,12456 ,17816 ,206343 ,428 ,626 ,7118 ,331 ,386 ,5320 
2019/8/23,30,27,3,103044,22466,409722,12510,3238,82695,115554 ,25704 ,492417 ,3816 ,832 ,15175 ,4170 ,1079 ,27565 
2019/8/24,30,23,7,10427,6940,29698,537,1743,18962,10964 ,8683 ,48660 ,453 ,302 ,1291 ,77 ,249 ,2709 
2019/8/25,30,22,8,12270,4560,76314,1097,1505,5691,13367 ,6065 ,82005 ,558 ,207 ,3469 ,137 ,188 ,711 
2019/8/26,30,27,3,12595,13282,120910,653,1674,52216,13248 ,14956 ,173126 ,466 ,492 ,4478 ,218 ,558 ,17405 
2019/8/27,30,24,6,4054,2643,15133,329,450,9055,4383 ,3093 ,24188 ,169 ,110 ,631 ,55 ,75 ,1509 
2019/8/28,30,21,9,3203,5877,27957,942,1862,74972,4145 ,7739 ,102929 ,153 ,280 ,1331 ,105 ,207 ,8330 
2019/8/29,30,23,7,2232,4644,90941,251,269,15959,2483 ,4913 ,106900 ,97 ,202 ,3954 ,36 ,38 ,2280 
2019/8/30,30,26,4,10023,11596,122501,939,948,4155,10962 ,12544 ,126656 ,386 ,446 ,4712 ,235 ,237 ,1039 
2019/8/31,30,23,7,9335,8904,35976,846,3732,19782,10181 ,12636 ,55758 ,406 ,387 ,1564 ,121 ,533 ,2826 
2019/9/1,30,24,6,3469,7258,79313,422,2505,11039,3891 ,9763 ,90352 ,145 ,302 ,3305 ,70 ,418 ,1840 
2019/9/2,30,18,12,5935,32126,132793,1493,5748,56440,7428 ,37874 ,189233 ,330 ,1785 ,7377 ,124 ,479 ,4703 
2019/9/3,30,25,5,7036,5755,70634,280,1190,6636,7316 ,6945 ,77270 ,281 ,230 ,2825 ,56 ,238 ,1327 
2019/9/4,30,21,9,3486,9480,73022,950,2880,20808,4436 ,12360 ,93830 ,166 ,451 ,3477 ,106 ,320 ,2312 
2019/9/5,30,22,8,18927,8863,55828,635,2533,12324,19562 ,11396 ,68152 ,860 ,403 ,2538 ,79 ,317 ,1541 
2019/9/6,30,28,2,5407,14275,121456,369,328,2094,5776 ,14603 ,123550 ,193 ,510 ,4338 ,185 ,164 ,1047 
2019/9/7,30,17,13,2113,5658,24807,1171,4225,34474,3284 ,9883 ,59281 ,124 ,333 ,1459 ,90 ,325 ,2652 
2019/9/8,30,24,6,2500,5224,27131,486,1292,11010,2986 ,6516 ,38141 ,104 ,218 ,1130 ,81 ,215 ,1835 
2019/9/9,30,27,3,6154,10483,56816,359,230,1504,6513 ,10713 ,58320 ,228 ,388 ,2104 ,120 ,77 ,501 
2019/9/10,30,14,16,18225,11564,41197,11685,2250,13296,29910 ,13814 ,54493 ,1302 ,826 ,2943 ,730 ,141 ,831 
2019/9/11,30,25,5,17988,36590,1062556,5248,31682,658918,23236 ,68272 ,1721474 ,720 ,1464 ,42502 ,1050 ,6336 ,131784 
2019/9/12,30,25,5,53708,20528,139621,828,2090,15709,54536 ,22618 ,155330 ,2148 ,821 ,5585 ,166 ,418 ,3142 
2019/9/13,30,24,6,2439,5451,59911,998,3033,17166,3437 ,8484 ,77077 ,102 ,227 ,2496 ,166 ,506 ,2861 
2019/9/14,30,15,15,1959,6655,17310,1426,3874,17986,3385 ,10529 ,35296 ,131 ,444 ,1154 ,95 ,258 ,1199 
2019/9/15,30,21,9,7648,6839,25004,1273,5482,21976,8921 ,12321 ,46980 ,364 ,326 ,1191 ,141 ,609 ,2442 
2019/9/16,30,19,11,13017,19269,273777,2107,3309,35708,15124 ,22578 ,309485 ,685 ,1014 ,14409 ,192 ,301 ,3246 
2019/9/17,30,15,15,1553,7581,39476,1361,4991,25087,2914 ,12572 ,64563 ,104 ,505 ,2632 ,91 ,333 ,1672 
2019/9/18,30,24,6,3224,9100,177272,1027,3629,22350,4251 ,12729 ,199622 ,134 ,379 ,7386 ,171 ,605 ,3725 
2019/9/19,30,28,2,36373,76149,1724117,1222,2629,96017,37595 ,78778 ,1820134 ,1299 ,2720 ,61576 ,611 ,1315 ,48009 
2019/9/20,30,24,6,19570,20452,525111,2369,5912,81580,21939 ,26364 ,606691 ,815 ,852 ,21880 ,395 ,985 ,13597 
2019/9/21,30,24,6,3267,5902,24337,879,4114,23640,4146 ,10016 ,47977 ,136 ,246 ,1014 ,147 ,686 ,3940 
2019/9/22,30,18,12,3589,7784,65245,1445,7407,74477,5034 ,15191 ,139722 ,199 ,432 ,3625 ,120 ,617 ,6206 
2019/9/23,30,25,5,9997,15036,200841,776,493,2138,10773 ,15529 ,202979 ,400 ,601 ,8034 ,155 ,99 ,428 
2019/9/24,30,23,7,7830,16481,211701,7669,7857,169126,15499 ,24338 ,380827 ,340 ,717 ,9204 ,1096 ,1122 ,24161 
2019/9/25,30,24,6,2116,5181,26743,616,3557,35116,2732 ,8738 ,61859 ,88 ,216 ,1114 ,103 ,593 ,5853 
2019/9/26,30,21,9,34024,65175,416984,2741,26626,666114,36765 ,91801 ,1083098 ,1620 ,3104 ,19856 ,305 ,2958 ,74013 
2019/9/27,30,19,11,6671,17888,133115,1856,9315,118206,8527 ,27203 ,251321 ,351 ,941 ,7006 ,169 ,847 ,10746 
2019/9/28,30,24,6,10671,11336,47063,781,3720,33119,11452 ,15056 ,80182 ,445 ,472 ,1961 ,130 ,620 ,5520 
2019/9/29,30,21,9,35927,21647,191181,5336,2705,12638,41263 ,24352 ,203819 ,1711 ,1031 ,9104 ,593 ,301 ,1404 
2019/9/30,30,25,5,12710,10323,32341,730,1436,4146,13440 ,11759 ,36487 ,508 ,413 ,1294 ,146 ,287 ,829 
2019-09-31,30,26,4,407621,123870,1106025,1326,3640,25433,408947 ,127510 ,1131458 ,15678 ,4764 ,42539 ,332 ,910 ,6358 
2019/10/1,30,20,10,6801,3130,40944,567,3960,24872,7368 ,7090 ,65816 ,340 ,157 ,2047 ,57 ,396 ,2487 
2019/10/2,30,15,15,639,2945,19979,1624,6722,28589,2263 ,9667 ,48568 ,43 ,196 ,1332 ,108 ,448 ,1906 
2019/10/3,30,19,11,3738,5394,31592,1020,7772,31554,4758 ,13166 ,63146 ,197 ,284 ,1663 ,93 ,707 ,2869 
2019/10/4,30,19,11,2017,5181,15035,817,9255,390486,2834 ,14436 ,405521 ,106 ,273 ,791 ,74 ,841 ,35499 
2019/10/5,30,16,14,8599,9687,123024,2560,7369,137481,11159 ,17056 ,260505 ,537 ,605 ,7689 ,183 ,526 ,9820 
2019/10/6,30,18,12,676,3066,12446,566,2687,14090,1242 ,5753 ,26536 ,38 ,170 ,691 ,47 ,224 ,1174 
2019/10/7,30,15,15,1611,3335,23309,2276,7235,74444,3887 ,10570 ,97753 ,107 ,222 ,1554 ,152 ,482 ,4963 
2019/10/8,30,20,10,84188,32898,250418,288,724,3965,84476 ,33622 ,254383 ,4209 ,1645 ,12521 ,29 ,72 ,397 
2019/10/9,30,20,10,3852,6393,20695,856,3798,23209,4708 ,10191 ,43904 ,193 ,320 ,1035 ,86 ,380 ,2321 
2019/10/10,30,19,11,1928,3232,27261,815,2760,14580,2743 ,5992 ,41841 ,101 ,170 ,1435 ,74 ,251 ,1325 
2019/10/11,30,19,11,8144,7827,32737,1469,6173,45709,9613 ,14000 ,78446 ,429 ,412 ,1723 ,134 ,561 ,4155 
2019/10/12,30,16,14,3991,6889,98887,2100,4913,29825,6091 ,11802 ,128712 ,249 ,431 ,6180 ,150 ,351 ,2130 
2019/10/13,30,19,11,2928,8150,123587,797,3587,20658,3725 ,11737 ,144245 ,154 ,429 ,6505 ,72 ,326 ,1878 
2019/10/14,30,25,5,2508,4253,21278,314,741,4818,2822 ,4994 ,26096 ,100 ,170 ,851 ,63 ,148 ,964 
2019/10/15,30,26,4,2681,3402,34236,518,434,5970,3199 ,3836 ,40206 ,103 ,131 ,1317 ,130 ,109 ,1493 
2019/10/16,30,25,5,2360,6225,88863,440,1761,68963,2800 ,7986 ,157826 ,94 ,249 ,3555 ,88 ,352 ,13793 
2019/10/17,30,18,12,4629,4631,20381,802,3429,18475,5431 ,8060 ,38856 ,257 ,257 ,1132 ,67 ,286 ,1540 
2019/10/18,30,25,5,14420,11344,58119,1411,2895,12054,15831 ,14239 ,70173 ,577 ,454 ,2325 ,282 ,579 ,2411 
2019/10/19,30,26,4,16828,11649,180705,705,1359,10211,17533 ,13008 ,190916 ,647 ,448 ,6950 ,176 ,340 ,2553 
2019/10/20,30,22,8,7546,3139,16624,1056,1746,13288,8602 ,4885 ,29912 ,343 ,143 ,756 ,132 ,218 ,1661 
2019/10/21,30,21,9,5240,6882,30670,503,2445,16053,5743 ,9327 ,46723 ,250 ,328 ,1460 ,56 ,272 ,1784 
2019/10/22,30,25,5,9603,4637,25647,965,1974,11391,10568 ,6611 ,37038 ,384 ,185 ,1026 ,193 ,395 ,2278 
2019/10/23,30,19,11,5413,8724,83214,2123,5669,85338,7536 ,14393 ,168552 ,285 ,459 ,4380 ,193 ,515 ,7758 
2019/10/24,30,23,7,5756,4892,15467,248,1909,6366,6004 ,6801 ,21833 ,250 ,213 ,672 ,35 ,273 ,909 
2019/10/25,30,21,9,5754,3820,91596,713,3058,47936,6467 ,6878 ,139532 ,274 ,182 ,4362 ,79 ,340 ,5326 
2019/10/26,30,20,10,20233,7975,27432,1012,2248,19964,21245 ,10223 ,47396 ,1012 ,399 ,1372 ,101 ,225 ,1996 
2019/10/27,30,25,5,5399,5604,28854,301,1218,8798,5700 ,6822 ,37652 ,216 ,224 ,1154 ,60 ,244 ,1760 
2019/10/28,30,19,11,8520,13560,138273,18944,5774,15621,27464 ,19334 ,153894 ,448 ,714 ,7278 ,1722 ,525 ,1420 
2019/10/29,30,23,7,9051,10517,51531,2461,1795,9622,11512 ,12312 ,61153 ,394 ,457 ,2240 ,352 ,256 ,1375 
2019/10/30,30,25,5,4919,7688,44459,1451,1157,14931,6370 ,8845 ,59390 ,197 ,308 ,1778 ,290 ,231 ,2986 
2019/10/31,30,25,5,8111,21539,38246,2213,2136,16274,10324 ,23675 ,54520 ,324 ,862 ,1530 ,443 ,427 ,3255 
2019/11/1,30,23,7,36594,36238,286965,4000,10727,124407,40594 ,46965 ,411372 ,1591 ,1576 ,12477 ,571 ,1532 ,17772 
2019/11/2,30,19,11,2982,6812,18512,2825,4685,28964,5807 ,11497 ,47476 ,157 ,359 ,974 ,257 ,426 ,2633 
2019/11/3,30,20,10,10453,9036,79628,1234,3049,14447,11687 ,12085 ,94075 ,523 ,452 ,3981 ,123 ,305 ,1445 
2019/11/4,30,22,8,16264,8415,26651,608,3679,14823,16872 ,12094 ,41474 ,739 ,383 ,1211 ,76 ,460 ,1853 
2019/11/5,30,21,9,5861,7641,76743,1284,2255,10627,7145 ,9896 ,87370 ,279 ,364 ,3654 ,143 ,251 ,1181 
2019/11/6,30,22,8,6017,16181,47247,534,1475,8786,6551 ,17656 ,56033 ,274 ,736 ,2148 ,67 ,184 ,1098 
2019/11/7,30,20,10,4530,6689,34184,2987,2229,15764,7517 ,8918 ,49948 ,227 ,334 ,1709 ,299 ,223 ,1576 
2019/11/8,30,24,6,9939,11998,66635,681,1691,5453,10620 ,13689 ,72088 ,414 ,500 ,2776 ,114 ,282 ,909 
2019/11/9,30,23,7,10355,19685,585079,456,2313,10392,10811 ,21998 ,595471 ,450 ,856 ,25438 ,65 ,330 ,1485 
2019/11/10,30,23,7,26759,16660,99122,672,2787,8622,27431 ,19447 ,107744 ,1163 ,724 ,4310 ,96 ,398 ,1232 
2019/11/11,30,17,13,26430,36895,247357,3476,4308,74724,29906 ,41203 ,322081 ,1555 ,2170 ,14550 ,267 ,331 ,5748 
2019/11/12,30,23,7,10689,9815,43917,565,2470,15060,11254 ,12285 ,58977 ,465 ,427 ,1909 ,81 ,353 ,2151 
2019/11/13,30,21,9,5317,3184,17142,1384,4788,19510,6701 ,7972 ,36652 ,253 ,152 ,816 ,154 ,532 ,2168 
2019/11/14,30,21,9,3717,4515,23685,283,2224,9168,4000 ,6739 ,32853 ,177 ,215 ,1128 ,31 ,247 ,1019 
2019/11/15,30,22,8,2867,5348,28110,999,3878,17026,3866 ,9226 ,45136 ,130 ,243 ,1278 ,125 ,485 ,2128 
2019/11/16,30,20,10,4275,5782,20620,3365,4124,38678,7640 ,9906 ,59298 ,214 ,289 ,1031 ,337 ,412 ,3868 
2019/11/17,30,19,11,3272,3503,24399,428,1814,10167,3700 ,5317 ,34566 ,172 ,184 ,1284 ,39 ,165 ,924 
2019/11/18,30,16,14,29635,20423,61307,1574,4083,32127,31209 ,24506 ,93434 ,1852 ,1276 ,3832 ,112 ,292 ,2295 
2019/11/19,30,27,3,22971,12893,82875,106,492,3069,23077 ,13385 ,85944 ,851 ,478 ,3069 ,35 ,164 ,1023 
2019/11/20,30,22,8,42026,17409,47183,247,2620,6910,42273 ,20029 ,54093 ,1910 ,791 ,2145 ,31 ,328 ,864 
2019/11/21,30,25,5,11271,14915,41410,1289,4747,19404,12560 ,19662 ,60814 ,451 ,597 ,1656 ,258 ,949 ,3881 
2019/11/22,30,24,6,28095,10128,61438,3172,2832,93333,31267 ,12960 ,154771 ,1171 ,422 ,2560 ,529 ,472 ,15556 
2019/11/23,30,21,9,11456,7197,24882,2725,5458,9041,14181 ,12655 ,33923 ,546 ,343 ,1185 ,303 ,606 ,1005 
2019/11/24,30,24,6,8067,6750,116008,780,1358,9064,8847 ,8108 ,125072 ,336 ,281 ,4834 ,130 ,226 ,1511 
2019/11/25,30,20,10,21043,18437,82296,3908,4683,30453,24951 ,23120 ,112749 ,1052 ,922 ,4115 ,391 ,468 ,3045 
2019/11/26,30,25,5,15774,24475,147078,1783,1451,9576,17557 ,25926 ,156654 ,631 ,979 ,5883 ,357 ,290 ,1915 
2019/11/27,30,20,10,16135,15629,34665,11506,5622,19548,27641 ,21251 ,54213 ,807 ,781 ,1733 ,1151 ,562 ,1955 
2019/11/28,30,21,9,68638,44889,82479,9666,6239,50824,78304 ,51128 ,133303 ,3268 ,2138 ,3928 ,1074 ,693 ,5647 
2019/11/29,30,18,12,34607,10340,62683,3429,5153,29010,38036 ,15493 ,91693 ,1923 ,574 ,3482 ,286 ,429 ,2418 
2019/11/30,30,17,13,31888,9625,64208,2809,6789,42853,34697 ,16414 ,107061 ,1876 ,566 ,3777 ,216 ,522 ,3296 
2019/12/1,30,9,21,2332,2167,12330,25325,45416,584334,27657 ,47583 ,596664 ,259 ,241 ,1370 ,1206 ,2163 ,27825 
2019/12/2,30,5,25,6494,20247,234291,44390,99641,1089909,50884 ,119888 ,1324200 ,1299 ,4049 ,46858 ,1776 ,3986 ,43596 
2019/12/3,30,9,21,60814,25372,207056,34840,63819,561526,95654 ,89191 ,768582 ,6757 ,2819 ,23006 ,1659 ,3039 ,26739 
2019/12/4,30,10,20,85368,19287,102893,11108,36729,328554,96476 ,56016 ,431447 ,8537 ,1929 ,10289 ,555 ,1836 ,16428 
2019/12/5,30,22,8,172577,54294,507817,15521,29744,203672,188098 ,84038 ,711489 ,7844 ,2468 ,23083 ,1940 ,3718 ,25459 
2019/12/6,30,16,14,66368,8980,109903,5377,6221,71299,71745 ,15201 ,181202 ,4148 ,561 ,6869 ,384 ,444 ,5093 
2019/12/7,30,18,12,87721,11229,92038,5133,10495,68341,92854 ,21724 ,160379 ,4873 ,624 ,5113 ,428 ,875 ,5695 
2019/12/8,30,23,7,21708,15002,62796,21842,3787,12866,43550 ,18789 ,75662 ,944 ,652 ,2730 ,3120 ,541 ,1838 
2019/12/9,30,19,11,3855,7556,90316,1530,3819,65126,5385 ,11375 ,155442 ,203 ,398 ,4753 ,139 ,347 ,5921 
2019/12/10,30,24,6,100348,22949,201492,1774,3562,22928,102122 ,26511 ,224420 ,4181 ,956 ,8396 ,296 ,594 ,3821 
2019/12/11,30,24,6,11741,17973,196521,1663,4681,23922,13404 ,22654 ,220443 ,489 ,749 ,8188 ,277 ,780 ,3987 
2019/12/12,30,24,6,53415,701625,1778343,1510,1336,79707,54925 ,702961 ,1858050 ,2226 ,29234 ,74098 ,252 ,223 ,13285 
2019/12/13,30,17,13,8716,13217,38572,949,1477,14254,9665 ,14694 ,52826 ,513 ,777 ,2269 ,73 ,114 ,1096 
2019/12/14,30,21,9,3658,9560,41856,570,2453,25162,4228 ,12013 ,67018 ,174 ,455 ,1993 ,63 ,273 ,2796 
2019/12/15,30,19,11,8222,13115,86533,1604,2436,17550,9826 ,15551 ,104083 ,433 ,690 ,4554 ,146 ,221 ,1595 
2019/12/16,30,22,8,10671,8052,78433,371,1683,13472,11042 ,9735 ,91905 ,485 ,366 ,3565 ,46 ,210 ,1684 
2019/12/17,30,21,9,8243,8350,40055,410,1538,33315,8653 ,9888 ,73370 ,393 ,398 ,1907 ,46 ,171 ,3702 
2019/12/18,30,20,10,10557,7522,25665,911,1935,21025,11468 ,9457 ,46690 ,528 ,376 ,1283 ,91 ,194 ,2103 
2019/12/19,30,21,9,10646,11022,98875,693,3152,64157,11339 ,14174 ,163032 ,507 ,525 ,4708 ,77 ,350 ,7129 
2019/12/20,30,21,9,5201,9564,42099,11699,5489,18605,16900 ,15053 ,60704 ,248 ,455 ,2005 ,1300 ,610 ,2067 
2019/12/21,30,26,4,32034,25339,61652,279,1808,8397,32313 ,27147 ,70049 ,1232 ,975 ,2371 ,70 ,452 ,2099 
2019/12/22,30,25,5,38134,23520,70677,289,2124,9567,38423 ,25644 ,80244 ,1525 ,941 ,2827 ,58 ,425 ,1913 
2019/12/23,30,25,5,200847,247853,1304064,647,2911,30244,201494 ,250764 ,1334308 ,8034 ,9914 ,52163 ,129 ,582 ,6049 
2019/12/24,30,18,12,10432,15732,32647,1695,2727,18840,12127 ,18459 ,51487 ,580 ,874 ,1814 ,141 ,227 ,1570 
2019/12/25,30,25,5,27120,38410,479062,513,1903,12494,27633 ,40313 ,491556 ,1085 ,1536 ,19162 ,103 ,381 ,2499 
2019/12/26,30,21,9,19338,6790,34564,1687,2916,25158,21025 ,9706 ,59722 ,921 ,323 ,1646 ,187 ,324 ,2795 
2019/12/27,30,25,5,6969,16224,48064,840,1143,6991,7809 ,17367 ,55055 ,279 ,649 ,1923 ,168 ,229 ,1398 
2019/12/28,30,22,8,43704,6914,31198,515,1596,12283,44219 ,8510 ,43481 ,1987 ,314 ,1418 ,64 ,200 ,1535 
2019/12/29,30,20,10,10951,10147,27749,2180,5779,30625,13131 ,15926 ,58374 ,548 ,507 ,1387 ,218 ,578 ,3063 
2019/12/30,30,24,6,19109,16872,105712,959,884,9368,20068 ,17756 ,115080 ,796 ,703 ,4405 ,160 ,147 ,1561 
2019/12/31,30,25,5,7262,9523,55140,441,3534,23653,7703 ,13057 ,78793 ,290 ,381 ,2206 ,88 ,707 ,4731 
